{
    "one": [
            [16,17,16,17,16,17,28,29,28,29,28,29,28,29,28,29,28,29,28,29,28,29,28,29,28,29,28,29,28,29,28,29,28,29,28,29,28,29,28,29,28,16,17,16,17,16,17],
            [18,19,18,19,18,19,30,31,30,31,30,31,30,31,30,31,30,31,30,31,30,31,30,31,30,31,30,31,30,31,30,31,30,31,30,31,30,31,30,31,30,18,19,18,19,18,19],
            [20,21,20,21,20,21,32,33,32,33,32,33,32,33,32,33,32,33,32,33,32,33,32,33,32,33,32,33,32,33,32,33,32,33,32,33,32,33,32,33,32,20,21,20,21,20,21],
            [16,17,16,17,16,17,22,0,0,0,0,0,0,0,0,0,0,0,0,0,0,0,0,0,0,0,0,0,0,0,0,0,0,0,0,0,0,0,0,0,25,16,17,16,17,16,17],
            [18,19,18,19,18,19,23,0,0,0,0,0,0,0,0,0,0,0,0,0,0,0,0,0,0,0,0,0,401,402,403,404,405,406,0,0,0,0,0,0,26,18,19,18,19,18,19],
            [20,21,20,21,20,21,24,0,0,0,0,0,0,0,0,0,0,0,0,0,0,0,10,11,0,0,0,0,411,412,413,414,415,416,0,0,0,0,0,0,27,20,21,20,21,20,21],
            [16,17,16,17,16,17,22,0,0,0,0,301,302,303,304,305,306,307,308,309,0,0,12,13,0,0,0,0,421,422,423,424,425,426,0,0,0,0,0,0,25,16,17,16,17,16,17],
            [18,19,18,19,18,19,23,0,0,0,0,311,312,313,314,315,316,317,318,319,0,0,14,15,0,0,0,0,7,7,7,0,0,0,0,0,10,11,0,0,26,18,19,18,19,18,19],
            [20,21,20,21,20,21,24,0,0,0,0,321,322,323,324,325,326,327,328,329,0,0,0,0,0,0,0,0,0,7,7,0,0,0,0,0,12,13,0,0,27,20,21,20,21,20,21],
            [16,17,16,17,16,17,22,0,0,0,0,331,332,333,334,335,336,337,338,339,0,0,0,0,0,0,0,0,0,7,7,0,0,0,0,0,14,15,0,0,25,16,17,16,17,16,17],
            [18,19,18,19,18,19,23,0,0,0,0,0,0,0,0,0,0,7,7,0,0,0,7,7,7,7,7,7,7,7,7,0,0,0,0,0,0,0,0,0,26,18,19,18,19,18,19],
            [20,21,20,21,20,21,24,0,0,0,10,11,0,0,0,0,0,7,7,0,0,7,7,7,7,7,7,7,7,7,7,0,0,0,0,0,0,0,0,0,27,20,21,20,21,20,21],
            [16,17,16,17,16,17,22,0,0,0,12,13,0,0,0,0,0,7,7,7,7,7,7,7,0,0,0,0,0,0,0,0,0,0,0,0,0,0,0,0,25,16,17,16,17,16,17],
            [18,19,18,19,18,19,23,0,0,0,14,15,0,0,0,0,0,7,7,7,7,7,7,0,0,0,0,0,201,202,203,204,205,206,0,0,0,0,0,0,26,18,19,18,19,18,19],
            [20,21,20,21,20,21,24,0,0,0,0,0,0,0,0,0,0,0,0,0,0,7,7,0,0,0,0,211,212,213,214,215,216,217,218,0,0,0,0,0,27,20,21,20,21,20,21],
            [16,17,16,17,16,17,22,0,0,0,0,0,101,102,103,0,0,0,0,0,0,7,7,0,10,11,0,221,222,223,224,225,226,227,228,0,0,10,11,0,25,16,17,16,17,16,17],
            [18,19,18,19,18,19,23,0,0,0,0,111,112,113,114,115,0,0,0,0,0,7,7,0,12,13,0,231,232,233,234,235,236,237,238,0,0,12,13,0,26,18,19,18,19,18,19],
            [20,21,20,21,20,21,24,0,10,11,0,121,122,123,124,125,126,127,0,0,0,7,7,0,14,15,0,241,242,243,244,245,246,247,248,0,0,14,15,0,27,20,21,20,21,20,21],
            [16,17,16,17,16,17,22,0,12,13,0,131,132,133,134,135,136,137,0,0,0,7,7,0,0,0,0,0,0,0,7,7,0,0,0,0,0,0,0,0,25,16,17,16,17,16,17],
            [18,19,18,19,18,19,23,0,14,15,0,141,142,143,144,145,146,147,0,0,0,7,7,7,7,7,7,7,7,7,7,7,0,0,0,0,0,0,0,0,26,18,19,18,19,18,19],
            [20,21,20,21,20,21,24,0,0,0,0,0,7,7,7,0,0,0,0,0,0,7,7,7,7,7,7,7,7,7,7,7,0,0,0,0,0,0,0,0,27,20,21,20,21,20,21],
            [16,17,16,17,16,17,22,0,0,0,0,0,7,7,7,7,7,7,7,7,7,7,7,0,0,0,0,0,0,0,0,0,0,0,0,0,0,0,0,0,25,16,17,16,17,16,17],
            [18,19,18,19,18,19,23,0,0,0,0,0,0,7,7,7,7,7,7,7,7,7,7,0,0,0,0,0,0,0,0,0,0,0,0,0,0,0,0,0,26,18,19,18,19,18,19],
            [20,21,20,21,20,21,24,0,0,0,0,0,0,0,0,0,0,0,0,0,0,0,0,0,0,0,0,0,0,0,0,0,0,0,0,0,0,0,0,0,0,20,21,20,21,20,21],
            [16,17,16,17,16,17,28,29,28,29,28,29,28,29,28,29,28,29,28,29,28,29,28,29,28,29,28,29,28,29,28,29,28,29,28,29,28,29,28,29,28,16,17,16,17,16,17],
            [18,19,18,19,18,19,30,31,30,31,30,31,30,31,30,31,30,31,30,31,30,31,30,31,30,31,30,31,30,31,30,31,30,31,30,31,30,31,30,31,30,18,19,18,19,18,19]

    ]
}
    
