{
    "one": [
            [16,17,16,17,16,17,28,29,28,29,28,29,28,29,28,29,28,29,28,29,28,29,28,29,28,29,28,29,28,29,28,29,28,29,28,29,28,29,28,29,28,16,17,16,17,16,17],
            [18,19,18,19,18,19,30,31,30,31,30,31,30,31,30,31,30,31,30,31,30,31,30,31,30,31,30,31,30,31,30,31,30,31,30,31,30,31,30,31,30,18,19,18,19,18,19],
            [20,21,20,21,20,21,32,33,32,33,32,33,32,33,32,33,32,33,32,33,32,33,32,33,32,33,32,33,32,33,32,33,32,33,32,33,32,33,32,33,32,20,21,20,21,20,21],
            [16,17,16,17,16,17,22,0,0,0,0,0,0,0,0,0,0,0,0,0,0,0,0,0,0,0,0,0,0,0,0,0,0,0,0,0,0,0,0,0,25,16,17,16,17,16,17],
            [18,19,18,19,18,19,23,0,0,0,0,0,0,0,0,0,0,0,0,0,0,0,0,0,0,0,0,0,8,8,8,8,8,8,8,8,0,0,0,0,26,18,19,18,19,18,19],
            [20,21,20,21,20,21,24,0,0,0,0,0,0,0,0,0,0,0,0,0,0,0,10,11,0,0,0,0,8,0,0,0,0,8,8,8,0,0,0,0,27,20,21,20,21,20,21],
            [16,17,16,17,16,17,22,0,0,0,0,8,8,8,8,8,8,8,8,8,0,0,12,13,0,0,0,0,8,5,8,8,8,8,0,0,0,0,0,0,25,16,17,16,17,16,17],
            [18,19,18,19,18,19,23,0,0,0,0,8,0,0,0,0,0,0,0,8,0,0,14,15,0,0,0,0,7,7,7,0,0,0,0,0,10,11,0,0,26,18,19,18,19,18,19],
            [20,21,20,21,20,21,24,0,0,0,0,8,0,0,0,0,0,0,0,8,0,0,0,0,0,0,0,0,0,7,7,0,0,0,0,0,12,13,0,0,27,20,21,20,21,20,21],
            [16,17,16,17,16,17,22,0,0,0,0,8,8,8,8,3,3,8,8,8,0,0,0,0,0,0,0,0,0,7,7,0,0,0,0,0,14,15,0,0,25,16,17,16,17,16,17],
            [18,19,18,19,18,19,23,0,0,0,0,0,0,0,0,7,7,0,0,0,0,0,7,7,7,7,7,7,7,7,7,0,0,0,0,0,0,0,0,0,26,18,19,18,19,18,19],
            [20,21,20,21,20,21,24,0,0,0,10,11,0,0,0,7,7,0,0,0,0,7,7,7,7,7,7,7,7,7,7,0,0,0,0,0,0,0,0,0,27,20,21,20,21,20,21],
            [16,17,16,17,16,17,22,0,0,0,12,13,0,0,0,7,7,7,7,7,7,7,7,7,0,0,0,0,0,0,0,0,0,0,0,0,0,0,0,0,25,16,17,16,17,16,17],
            [18,19,18,19,18,19,23,0,0,0,14,15,0,0,0,7,7,7,7,7,7,7,7,0,0,0,0,0,0,0,0,0,0,0,0,0,0,0,0,0,26,18,19,18,19,18,19],
            [20,21,20,21,20,21,24,0,0,0,0,0,0,0,0,0,0,0,0,0,0,7,7,0,0,0,0,8,8,8,8,8,8,8,8,8,0,0,0,0,27,20,21,20,21,20,21],
            [16,17,16,17,16,17,22,0,0,0,0,0,0,0,0,0,0,0,0,0,0,7,7,0,10,11,0,8,0,0,0,0,0,0,0,8,0,10,11,0,25,16,17,16,17,16,17],
            [18,19,18,19,18,19,23,0,0,0,0,8,8,8,8,8,0,0,0,0,0,7,7,0,12,13,0,8,0,0,0,0,0,0,0,8,0,12,13,0,26,18,19,18,19,18,19],
            [20,21,20,21,20,21,24,0,10,11,0,8,0,0,0,8,8,8,0,0,0,7,7,0,14,15,0,8,8,8,4,4,8,8,8,8,0,14,15,0,27,20,21,20,21,20,21],
            [16,17,16,17,16,17,22,0,12,13,0,8,0,0,0,8,0,8,0,0,0,7,7,0,0,0,0,0,0,0,7,7,0,0,0,0,0,0,0,0,25,16,17,16,17,16,17],
            [18,19,18,19,18,19,23,0,14,15,0,8,8,2,8,8,8,8,0,0,0,7,7,7,7,7,7,7,7,7,7,7,0,0,0,0,0,0,0,0,26,18,19,18,19,18,19],
            [20,21,20,21,20,21,24,0,0,0,0,0,7,7,7,0,0,0,0,0,0,7,7,7,7,7,7,7,7,7,7,7,0,0,0,0,0,0,0,0,27,20,21,20,21,20,21],
            [16,17,16,17,16,17,22,0,0,0,0,0,7,7,7,7,7,7,7,7,7,7,7,0,0,0,0,0,0,0,0,0,0,0,0,0,0,0,0,0,25,16,17,16,17,16,17],
            [18,19,18,19,18,19,23,0,0,0,0,0,0,7,7,7,7,7,7,7,7,7,7,0,0,0,0,0,0,0,0,0,0,0,0,0,0,0,0,0,26,18,19,18,19,18,19],
            [20,21,20,21,20,21,24,0,0,0,0,0,0,0,0,0,0,0,0,0,0,0,0,0,0,0,0,0,0,0,0,0,0,0,0,0,0,0,0,0,0,20,21,20,21,20,21],
            [16,17,16,17,16,17,28,29,28,29,28,29,28,29,28,29,28,29,28,29,28,29,28,29,28,29,28,29,28,29,28,29,28,29,28,29,28,29,28,29,28,16,17,16,17,16,17],
            [18,19,18,19,18,19,30,31,30,31,30,31,30,31,30,31,30,31,30,31,30,31,30,31,30,31,30,31,30,31,30,31,30,31,30,31,30,31,30,31,30,18,19,18,19,18,19]

    ]
}
    
